32 32 32 32 32 32 32 32 32 32 32 32 32 32 32 32 32 32 32 32 32 32 32 32 32 32 32 32 32 32 32 32 32 32 32 32 32 32 32 32 32 32 32 32 32 32 32 32 32 32 
32 32 32 32 32 32 32 32 32 32 32 32 32 32 32 32 32 32 32 32 32 32 32 32 32 32 32 32 32 32 32 32 32 32 32 32 32 32 32 32 32 32 32 32 32 32 32 32 32 32 
32 32 32 32 32 32 32 32 32 32 32 32 32 32 32 32 32 32 32 32 32 32 32 32 32 32 32 32 32 32 32 32 32 32 32 32 32 32 32 32 32 32 32 32 32 32 32 32 32 32 
32 32 32 32 32 32 32 32 32 32 32 32 32 32 32 32 32 32 32 32 32 32 32 32 32 32 32 32 32 32 32 32 32 32 32 32 32 32 32 32 32 32 32 32 32 32 32 32 32 32 
32 32 32 32 32 32 32 32 32 32 32 32 32 32 32 32 32 32 32 32 32 32 32 32 32 32 32 32 32 32 32 32 32 32 32 32 32 32 32 32 32 32 32 32 32 32 32 32 32 32 
32 32 32 32 32 32 32 32 32 32 32 32 32 32 32 32 32 32 32 32 32 32 32 32 32 32 32 32 32 32 32 32 32 32 32 32 32 32 32 32 32 32 32 32 32 32 32 32 32 32 
32 32 32 32 32 32 32 32 32 32 32 32 32 32 32 32 32 32 32 32 32 32 32 32 32 32 32 32 32 32 32 32 32 32 32 32 32 32 32 32 32 32 32 32 32 32 32 32 32 32 
32 32 32 32 32 32 32 36 37 37 37 37 37 37 37 37 37 37 37 37 37 37 37 37 37 37 37 37 37 37 37 37 37 37 37 37 37 37 37 32 32 32 32 32 32 32 32 32 32 32 
32 32 32 32 32 32 32 37 37 37 37 37 37 37 37 37 37 37 37 37 37 37 37 37 37 37 37 37 37 37 37 37 37 37 37 37 37 37 37 32 32 32 32 32 32 32 32 32 32 32 
32 32 32 32 32 32 32 32 32 32 32 32 37 37 32 32 32 32 32 32 32 32 32 32 32 32 32 32 32 32 32 32 32 32 32 32 32 37 37 37 37 37 32 32 32 32 32 32 32 32 
32 32 32 32 32 32 32 32 32 32 32 32 37 37 32 32 32 32 32 32 32 32 32 32 32 32 32 32 32 32 32 32 32 32 32 32 32 37 37 37 37 37 32 32 32 32 32 32 32 32 
32 32 32 32 32 32 32 32 32 32 32 32 37 37 32 32 32 32 32 32 32 32 32 32 32 32 32 32 32 32 32 32 32 32 32 32 32 32 32 32 37 37 32 32 32 32 32 32 32 32 
32 32 32 32 32 32 32 32 32 32 32 32 37 37 32 32 32 32 32 32 32 32 32 32 32 32 32 32 32 32 32 32 32 32 32 32 32 32 32 32 37 37 32 32 32 32 32 32 32 32 
32 32 32 32 32 32 32 32 37 37 37 37 37 37 37 37 37 37 37 37 37 37 32 32 32 32 32 32 32 32 32 37 37 37 37 37 32 37 37 32 32 37 37 32 32 32 32 32 32 32 
32 32 32 32 32 32 32 37 37 37 37 37 37 37 37 37 37 37 37 37 37 37 37 32 32 32 32 32 32 32 32 37 32 37 37 37 37 37 37 37 32 32 37 32 32 32 32 32 32 32 
32 32 32 32 32 32 32 37 37 37 37 37 37 37 37 37 37 37 37 37 37 37 37 32 32 32 32 32 32 32 32 37 37 37 32 37 37 37 37 37 37 32 37 32 32 32 32 32 32 32 
32 32 32 32 32 32 32 37 37 37 37 37 37 37 37 37 37 37 37 37 37 37 37 37 37 37 37 37 37 37 37 37 37 37 37 37 37 32 37 37 37 32 37 32 32 32 32 32 32 32 
32 32 32 32 32 32 32 37 37 37 37 37 37 37 37 37 37 37 37 37 37 37 37 37 32 32 32 32 32 32 32 37 32 37 37 37 37 37 37 37 37 37 37 32 32 32 32 32 32 32 
32 32 32 32 32 32 32 37 37 37 37 37 37 37 37 37 37 37 37 37 37 37 37 32 32 32 32 32 32 32 32 32 32 32 32 32 32 32 32 32 32 32 32 32 32 32 32 32 32 32 
32 32 32 32 32 32 32 32 37 37 37 37 37 37 37 37 37 37 37 37 37 37 32 32 32 32 32 32 32 32 32 32 32 32 32 32 32 32 32 32 32 32 32 32 32 32 32 32 32 32 
32 32 32 32 32 32 32 32 32 32 32 32 32 32 32 32 32 32 32 37 37 37 32 32 32 32 32 32 32 32 32 32 32 37 37 37 32 37 37 32 32 32 32 32 32 32 32 32 32 32 
32 32 32 32 32 32 32 32 32 32 32 32 32 32 32 32 32 32 32 32 37 32 32 32 32 32 32 32 32 32 32 32 37 32 37 32 32 37 32 37 37 37 32 32 32 32 32 32 32 32 
32 32 32 32 32 32 32 32 32 32 32 32 32 32 32 32 32 32 32 32 37 32 32 32 32 32 32 32 32 37 32 37 37 37 37 32 37 37 32 37 37 37 37 32 32 32 32 32 32 32 
32 32 32 32 32 32 32 32 32 32 32 32 32 32 32 32 32 32 32 32 37 32 32 32 32 32 32 32 32 37 37 37 37 32 37 37 37 37 37 37 32 37 37 32 32 32 32 32 32 32 
32 32 32 32 32 32 32 32 32 32 32 32 32 32 32 32 32 32 32 32 37 37 37 37 37 37 37 37 37 37 32 32 37 32 32 32 32 37 37 32 37 37 37 32 32 32 32 32 32 32 
32 32 32 32 32 32 32 32 32 37 37 37 36 32 32 32 32 32 32 32 37 37 32 32 32 32 32 32 32 37 32 37 37 37 37 32 37 37 32 32 37 32 37 32 32 32 32 32 32 32 
32 32 32 32 32 32 32 32 32 37 37 37 37 32 32 32 32 32 32 32 37 32 32 32 32 32 32 32 32 37 32 32 32 37 37 37 37 32 32 32 37 37 32 32 32 32 32 32 32 32 
32 32 32 32 32 32 32 32 32 37 37 37 37 32 32 32 32 32 32 32 32 32 32 32 32 32 32 32 32 37 37 37 32 32 32 32 37 37 37 37 37 37 37 32 32 32 32 32 32 32 
32 32 32 32 32 32 32 32 32 37 37 37 37 32 32 32 32 32 32 32 32 32 32 32 32 32 32 32 32 32 37 37 37 37 37 37 32 32 37 32 37 32 32 32 32 32 32 32 32 32 
32 32 32 32 32 32 32 32 32 37 32 32 32 32 32 32 32 32 32 32 32 32 32 32 32 32 32 32 32 32 32 37 32 32 32 37 37 32 37 37 37 32 32 32 32 32 32 32 32 32 
32 32 32 32 32 32 32 32 32 37 32 32 32 32 32 32 32 32 32 32 32 32 32 32 32 32 32 32 32 32 32 32 37 37 37 37 32 37 37 32 32 32 32 32 32 32 32 32 32 32 
32 32 32 32 32 32 32 32 32 37 32 32 32 32 32 37 37 37 37 37 37 37 37 37 37 37 37 32 32 32 32 32 32 32 32 32 32 37 32 32 32 32 32 32 32 32 32 32 32 32 
32 32 32 32 32 32 32 32 32 37 32 32 32 32 37 37 37 37 37 37 37 37 37 37 37 37 37 37 37 32 32 32 32 32 32 32 32 37 37 37 37 32 32 32 32 32 32 32 32 32 
32 32 32 32 32 32 32 32 32 37 32 32 32 32 37 37 37 37 37 37 37 37 37 37 37 37 37 37 37 37 32 32 32 32 32 32 32 32 37 37 37 37 32 32 32 32 32 32 32 32 
32 32 32 32 32 32 32 32 32 37 37 37 37 37 37 37 37 37 37 37 37 37 37 37 37 37 37 37 37 37 37 32 32 32 32 32 32 32 32 32 37 37 32 32 32 32 32 32 32 32 
32 32 32 32 32 32 32 32 32 32 32 32 32 32 37 37 37 37 37 37 37 37 37 37 37 37 37 37 37 37 37 32 32 32 32 32 32 32 32 32 37 37 37 32 32 32 32 32 32 32 
32 32 32 32 32 32 32 32 32 32 32 32 32 37 37 37 37 37 37 37 37 37 37 37 37 37 37 37 37 37 37 37 32 32 32 32 32 32 32 32 37 37 37 32 32 32 32 32 32 32 
32 32 32 32 32 32 32 32 32 32 32 32 32 37 37 37 37 37 37 37 37 37 37 37 37 37 37 37 37 37 37 37 32 32 32 32 32 32 37 37 37 37 32 32 32 32 32 32 32 32 
32 32 32 32 32 32 32 32 32 32 32 32 37 37 37 37 37 37 37 37 37 37 37 37 37 37 37 37 37 37 37 37 32 32 32 32 32 32 37 37 37 37 32 32 32 32 32 32 32 32 
32 32 32 32 32 32 32 32 32 37 37 37 37 37 37 37 37 37 37 37 37 37 37 37 37 37 37 37 37 37 37 37 32 37 37 37 32 37 37 37 32 32 32 32 32 32 32 32 32 32 
32 32 32 32 32 32 32 32 32 37 37 37 37 32 32 32 32 32 37 37 37 37 37 37 37 37 37 37 37 37 32 37 37 37 32 37 37 37 32 32 32 32 32 32 32 32 32 32 32 32 
32 32 32 32 32 32 32 32 32 37 37 37 32 32 32 32 32 32 32 37 37 37 37 37 37 37 37 37 37 32 32 32 32 32 32 32 32 32 32 32 32 32 32 32 32 32 32 32 32 32 
32 32 32 32 32 32 32 32 32 32 32 32 32 32 32 32 32 32 32 32 32 37 37 37 37 37 37 32 32 32 32 32 32 32 32 32 32 32 32 32 32 32 32 32 32 32 32 32 32 32 
32 32 32 32 32 32 32 32 32 32 32 32 32 32 32 32 32 32 32 32 32 32 32 32 32 32 32 32 32 32 32 32 32 32 32 32 32 32 32 32 32 32 32 32 32 32 32 32 32 32 
32 32 32 32 32 32 32 32 32 32 32 32 32 32 32 32 32 32 32 32 32 32 32 32 32 32 32 32 32 32 32 32 32 32 32 32 32 32 32 32 32 32 32 32 32 32 32 32 32 32 
32 32 32 32 32 32 32 32 32 32 32 32 32 32 32 32 32 32 32 32 32 32 32 32 32 32 32 32 32 32 32 32 32 32 32 32 32 32 32 32 32 32 32 32 32 32 32 32 32 32 
32 32 32 32 32 32 32 32 32 32 32 32 32 32 32 32 32 32 32 32 32 32 32 32 32 32 32 32 32 32 32 32 32 32 32 32 32 32 32 32 32 32 32 32 32 32 32 32 32 32 
32 32 32 32 32 32 32 32 32 32 32 32 32 32 32 32 32 32 32 32 32 32 32 32 32 32 32 32 32 32 32 32 32 32 32 32 32 32 32 32 32 32 32 32 32 32 32 32 32 32 
32 32 32 32 32 32 32 32 32 32 32 32 32 32 32 32 32 32 32 32 32 32 32 32 32 32 32 32 32 32 32 32 32 32 32 32 32 32 32 32 32 32 32 32 32 32 32 32 32 32 
32 32 32 32 32 32 32 32 32 32 32 32 32 32 32 32 32 32 32 32 32 32 32 32 32 32 32 32 32 32 32 32 32 32 32 32 32 32 32 32 32 32 32 32 32 32 32 32 32 32 
