16 16 16 16 16 16 16 16 16 16 16 16 16 16 16 16 16 16 16 16 16 16 16 16 16 16 16 16 16 16 16 16 16 16 16 16 16 16 16 16 16 16 16 16 16 16 16 16 16 16 
16 16 16 16 16 16 16 16 16 16 16 16 16 16 16 16 16 16 16 16 16 16 16 16 16 16 16 16 16 16 16 16 16 16 16 16 16 16 16 16 16 16 16 16 16 16 16 16 16 16 
16 16 16 16 16 16 16 16 16 16 16 16 16 16 16 16 16 16 16 16 16 16 16 16 16 16 16 16 16 16 16 16 16 16 16 16 16 16 16 16 16 16 16 16 16 16 16 16 16 16 
16 16 16 16 16 16 16 16 16 16 16 16 16 16 16 16 16 16 16 16 16 16 16 16 16 16 16 16 16 16 16 16 16 16 16 16 16 16 16 16 16 16 16 16 16 16 16 16 16 16 
16 16 16 16 16 16 16 16 16 16 16 16 16 16 16 16 16 16 16 16 16 16 16 16 16 16 16 16 16 16 16 16 16 16 16 16 16 16 16 16 16 16 16 16 16 16 16 16 16 16 
16 16 16 16 16 16 16 16 16 16 16 1 1 1 1 1 1 1 1 1 1 1 2 1 1 1 16 16 16 16 16 16 16 16 16 16 16 16 16 16 16 16 16 16 16 16 16 16 16 16 
16 16 16 16 16 16 16 16 16 16 16 1 1 1 1 16 16 16 16 16 16 1 1 16 16 1 16 16 16 16 16 16 16 16 16 16 16 16 16 16 16 16 16 16 16 16 16 16 16 16 
16 16 16 16 16 16 16 16 16 16 16 1 1 1 1 1 1 1 1 1 16 16 16 16 16 1 16 16 16 16 16 16 16 16 12 10 10 10 10 10 10 10 10 13 16 16 16 16 16 16 
16 16 16 16 16 16 16 16 16 16 16 1 1 2 1 1 1 1 1 1 1 1 1 1 1 1 16 16 16 16 16 16 16 16 8 3 3 3 3 3 3 3 3 7 16 16 16 16 16 16 
16 16 16 16 16 16 16 16 16 16 16 1 1 1 1 1 1 1 1 1 1 1 1 2 1 1 16 16 16 16 16 16 16 16 8 3 4 5 5 5 5 6 3 7 16 16 16 16 16 16 
16 16 16 16 16 16 16 16 16 16 16 1 1 1 1 1 1 1 1 1 1 1 1 1 1 1 16 16 16 16 16 16 16 16 8 3 7 16 16 16 16 8 3 7 16 16 16 16 16 16 
16 16 16 16 16 16 16 16 16 16 16 16 16 16 16 16 16 1 16 1 1 1 16 16 1 1 16 16 16 16 16 16 16 16 8 3 7 16 16 16 16 8 3 7 16 16 16 16 16 16 
16 16 16 16 16 16 16 16 16 16 16 16 16 16 1 1 1 1 16 1 1 1 1 16 1 1 16 16 16 16 16 16 16 16 8 3 7 16 16 16 16 8 3 7 16 16 16 16 16 16 
16 16 16 16 16 16 16 16 16 16 16 16 16 16 1 16 16 16 16 1 1 1 16 16 16 1 16 16 16 16 16 16 16 16 8 3 7 16 16 16 16 8 3 7 16 16 16 16 16 16 
16 16 16 16 16 16 16 16 16 16 16 16 16 16 1 16 16 16 16 1 2 1 1 1 1 1 16 16 16 16 16 16 16 16 8 3 7 16 16 16 16 8 3 7 16 16 16 16 16 16 
16 16 16 16 16 16 16 16 16 16 16 16 16 16 1 16 16 16 16 1 1 1 1 1 1 2 16 16 16 16 16 16 16 16 8 3 7 16 16 16 16 8 3 7 16 16 16 16 16 16 
16 16 16 16 16 16 16 16 16 16 16 16 16 16 1 16 16 16 16 16 16 16 16 16 16 16 16 16 16 16 16 16 16 16 8 3 7 16 16 16 16 8 3 7 16 16 16 16 16 16 
16 16 16 16 16 16 16 16 16 16 16 16 16 16 1 16 16 16 16 16 16 16 16 16 16 16 16 16 16 16 16 16 16 16 8 3 7 16 16 16 16 8 3 7 16 16 16 16 16 16 
16 16 16 16 16 16 16 16 16 16 16 16 16 16 1 16 16 16 16 16 16 16 16 16 16 16 16 16 16 16 12 10 10 10 11 3 7 16 16 16 16 8 3 7 16 16 16 16 16 16 
16 16 16 16 16 16 16 16 16 16 16 16 16 16 1 16 16 16 16 16 16 16 16 16 16 16 16 16 16 16 8 3 3 3 3 3 7 16 16 16 16 8 3 7 16 16 16 16 16 16 
16 16 16 16 16 16 16 16 1 1 1 1 1 1 1 1 1 1 1 1 1 1 1 1 16 16 16 16 16 16 8 3 4 5 5 5 15 16 16 16 16 8 3 7 16 16 16 16 16 16 
16 16 16 16 16 16 16 16 1 1 2 1 1 8 3 7 1 1 1 1 1 1 2 1 16 16 16 16 16 16 8 3 7 16 16 16 16 16 16 16 16 8 3 7 16 16 16 16 16 16 
16 16 16 16 16 16 16 16 12 10 10 10 13 8 3 7 2 1 1 1 1 1 1 1 1 16 16 16 16 16 8 3 7 16 16 16 16 16 16 16 16 8 3 7 16 16 16 16 16 16 
16 16 16 16 16 16 16 16 8 3 3 3 9 11 3 9 10 10 10 10 10 10 10 10 10 10 10 10 10 10 11 3 7 16 16 16 16 16 16 16 16 8 3 7 16 16 16 16 16 16 
16 16 16 16 16 16 16 16 8 3 3 3 3 3 3 3 3 3 3 3 3 3 3 3 3 3 3 3 3 3 3 3 7 16 16 16 16 16 16 16 16 8 3 7 16 16 16 16 16 16 
16 16 16 16 16 16 16 16 8 3 3 3 4 6 3 4 5 5 5 5 5 5 5 5 5 5 5 5 5 5 5 5 15 16 16 16 16 16 16 16 16 8 3 7 16 16 16 16 16 16 
16 16 16 16 16 16 16 16 14 5 5 5 15 8 3 7 1 1 1 1 1 1 1 16 16 16 16 16 16 16 16 1 16 16 16 16 16 16 16 16 16 8 3 7 16 16 16 16 16 16 
16 16 16 16 16 16 16 16 1 1 1 1 1 8 3 7 1 1 1 1 1 16 1 1 16 16 16 16 16 16 16 1 16 16 16 16 16 16 16 16 16 8 3 7 16 16 16 16 16 16 
16 16 16 16 16 16 16 16 1 1 1 1 1 8 3 7 1 1 2 1 1 16 1 38 16 16 16 16 16 16 16 1 16 16 16 16 16 16 16 16 16 8 3 7 16 16 16 16 16 16 
16 16 16 16 16 16 16 16 16 16 16 16 16 8 3 7 16 16 16 16 16 16 16 16 16 16 16 16 1 1 1 1 1 1 1 16 16 16 16 16 16 1 1 1 16 16 16 16 16 16 
16 16 16 16 16 16 16 16 16 16 16 16 16 8 3 7 16 16 16 16 16 16 16 16 16 16 16 1 1 1 2 1 1 1 1 1 1 16 16 16 16 1 1 16 16 16 16 16 16 16 
16 16 16 16 16 16 16 16 16 16 16 16 16 8 3 7 16 16 16 16 16 16 16 16 16 16 1 1 1 1 16 16 16 16 1 1 1 16 16 16 16 1 2 16 16 16 16 16 16 16 
16 16 16 16 16 16 16 16 16 16 16 16 16 8 3 7 16 16 16 16 16 16 16 16 16 16 1 1 2 16 16 16 16 16 1 1 2 16 16 16 16 1 1 16 16 16 16 16 16 16 
16 16 16 16 16 16 16 16 16 16 16 16 16 1 1 1 16 16 16 16 16 16 16 16 16 16 1 2 1 16 16 16 16 16 1 1 1 16 16 16 16 2 1 16 16 16 16 16 16 16 
16 16 16 16 16 16 16 16 16 16 16 16 16 16 1 16 16 16 16 16 16 16 16 16 16 16 1 1 1 1 16 1 16 1 1 2 1 16 16 16 16 1 16 16 16 16 16 16 16 16 
16 16 16 16 16 16 16 16 16 16 16 16 16 16 1 1 16 16 16 16 16 16 16 16 16 16 16 1 1 1 1 1 2 1 1 1 16 16 16 16 16 1 16 16 16 16 16 16 16 16 
16 16 16 16 16 16 16 16 16 16 16 16 16 16 16 1 1 16 16 16 16 16 16 16 16 16 16 16 1 1 1 1 1 16 16 16 16 16 16 16 16 1 16 16 16 16 16 16 16 16 
16 16 16 16 16 16 16 16 16 16 16 16 16 16 16 16 1 2 16 16 16 16 16 16 16 16 16 16 16 16 16 16 16 16 16 16 16 16 16 16 16 1 16 16 16 16 16 16 16 16 
16 16 16 16 1 1 1 1 1 1 1 1 1 16 16 16 16 1 1 16 16 16 16 16 16 16 16 16 16 16 16 16 16 16 16 16 16 38 1 1 1 2 1 16 16 16 16 16 16 16 
16 16 16 16 1 1 16 1 1 16 1 2 1 16 16 16 16 16 1 16 16 16 16 16 16 16 16 16 16 16 16 16 16 16 16 16 16 16 16 1 1 1 1 16 16 16 16 16 16 16 
16 16 16 16 1 1 1 2 1 1 1 1 1 16 16 16 16 16 1 16 16 16 16 16 16 16 16 16 16 33 1 1 1 1 1 1 1 1 1 1 1 1 1 16 16 16 16 16 16 16 
16 16 16 16 1 1 1 1 1 1 1 1 16 16 16 16 16 16 1 16 16 16 16 16 16 1 1 1 16 16 1 16 16 16 16 16 16 16 1 2 1 1 1 16 16 16 16 16 16 16 
16 16 16 16 1 1 1 1 1 16 1 1 1 1 1 1 1 1 1 1 2 1 1 16 16 1 1 1 16 16 1 16 16 16 16 16 16 16 1 1 1 36 1 16 16 16 16 16 16 16 
16 16 16 16 1 1 16 1 1 2 1 1 1 16 16 16 16 16 16 16 16 16 1 16 16 16 1 16 16 16 2 16 16 16 16 16 16 16 16 16 16 16 16 16 16 16 16 16 16 16 
16 16 16 16 1 1 1 1 1 1 1 1 16 16 16 16 16 16 16 16 16 16 1 1 1 1 1 1 1 1 1 16 16 16 16 16 16 16 16 16 16 16 16 16 16 16 16 16 16 16 
16 16 16 16 1 2 1 1 14 1 1 1 1 16 16 16 16 16 16 16 16 16 16 16 16 16 16 16 16 16 16 16 16 16 16 16 16 16 16 16 16 16 16 16 16 16 16 16 16 16 
16 16 16 16 1 1 1 1 16 1 1 16 1 16 16 16 16 16 16 16 16 16 16 16 16 16 16 16 16 16 16 16 16 16 16 16 16 16 16 16 16 16 16 16 16 16 16 16 16 16 
16 16 16 16 16 16 16 16 16 16 16 16 16 16 16 16 16 16 16 16 16 16 16 16 16 16 16 16 16 16 16 16 16 16 16 16 16 16 16 16 16 16 16 16 16 16 16 16 16 16 
16 16 16 16 16 16 16 16 16 16 16 16 16 16 16 16 16 16 16 16 16 16 16 16 16 16 16 16 16 16 16 16 16 16 16 16 16 16 16 16 16 16 16 16 16 16 16 16 16 16 
16 16 16 16 16 16 16 16 16 16 16 16 16 16 16 16 16 16 16 16 16 16 16 16 16 16 16 16 16 16 16 16 16 16 16 16 16 16 16 16 16 16 16 16 16 16 16 16 16 16 
